222222222222222222222222
233111122222111133222222
232111111111111123222222
211211332323911211222222
211121211211212111222222
211121311211212111222222
211121332323312111222222
211121211211212111222222
211211211211312111222222
212111832323311211222222
232111111111111123222222
233111122222111133222222
222222222222222222222222