222222222222222222222222
222211111111111222222222
222111133233111122222222
221111331113311112222222
221113311111331112222222
221113111211131112222222
221112112321121112222222
221113111211131112222222
221113311111331112222222
221111331113311112222222
222111138293111122222222
222211111111111222222222
222222222222222222222222