222222222222222222222222
222111111111111122222222
222133223132233122222222
221131113131113112222222
221131113131113112222222
211133323932333111222222
211112111111121111222222
211112131113121111222222
221113111111131112222222
221113111811131112222222
222113223332231122222222
222211111111111222222222
222222222222222222222222