222222222222222222222222
223221111111111111222222
232211323232323331222222
222111213121212131222222
232211323233323231222222
223221212121212121222222
232933323232833231222222
223221312121213121222222
232211333232323231222222
222111212131212121222222
232211323232333231222222
223221111111111111222222
222222222222222222222222